WM8S_Morse	KEYWORD1

pin_t	KEYWORD1

charElement_t	KEYWORD1
charElemMap_elements_t	KEYWORD1
difficulty_t	KEYWORD1
charElemMap_numElems_t	KEYWORD1
city_t	KEYWORD1
duration_t	KEYWORD1
eepromSignature_t	KEYWORD1
firstName_t	KEYWORD1
hz_t	KEYWORD1
qsoPart_t	KEYWORD1
wpm_t	KEYWORD1
wpmFactor_t	KEYWORD1

QSOPart_Row	KEYWORD1
RunMode	KEYWORD1

begin	KEYWORD2
charDahMarkTime	KEYWORD2
charDitMarkTime	KEYWORD2
charDitSpaceTime	KEYWORD2
charSpeed	KEYWORD2
charsRemainInMsg	KEYWORD2
elemsRemainInChar	KEYWORD2
farnsworthDelayTime	KEYWORD2
getRandomCall	KEYWORD2
getRandomCity	KEYWORD2
getRandomName	KEYWORD2
getRandomRST	KEYWORD2
enabledDifficulty	KEYWORD2
interCharSpaceTime	KEYWORD2
interWordSpaceTime	KEYWORD2
message	KEYWORD2
msgDone	KEYWORD2
overallSpeed	KEYWORD2
pitch	KEYWORD2
resetSettings	KEYWORD2
runMode	KEYWORD2
sendMark	KEYWORD2
sendMessage	KEYWORD2
sendNextElem	KEYWORD2
sendSpace	KEYWORD2
sendUntilMsgDone	KEYWORD2
setEnabledDifficulty	KEYWORD2
setMessage	KEYWORD2
setOverallSpeed	KEYWORD2
setPitch	KEYWORD2
setRunMode	KEYWORD2
setTonePin	KEYWORD2
setUserCharSpeed	KEYWORD2
setWpmSchemeFactor	KEYWORD2
tonePin	KEYWORD2
userCharSpeed	KEYWORD2
waitInterCharSpace	KEYWORD2
waitInterElemSpace	KEYWORD2
waitInterWordSpace	KEYWORD2
wpmSchemeFactor	KEYWORD2

FB1	LITERAL1
FB2	LITERAL1
FB3	LITERAL1
FB4	LITERAL1
FB5	LITERAL1
DE	LITERAL1
RST1	LITERAL1
RST2	LITERAL1
Name1	LITERAL1
Name2	LITERAL1
Name3	LITERAL1
Name4	LITERAL1
QTH1	LITERAL1
QTH2	LITERAL1
Bk2U1	LITERAL1
Bk2U2	LITERAL1
Bk2U3	LITERAL1
K1	LITERAL1
K2	LITERAL1
Idle	LITERAL1
SendMessage	LITERAL1
SendChars	LITERAL1
SendGroups	LITERAL1
SendQSOs	LITERAL1
SendFile	LITERAL1

WM8S_ARRAY_SIZE	LITERAL1
WM8S_END_OF_STRING	LITERAL1
WM8S_MORSE_CHAR_ELEMENT_MAP_DIFFICULTY_SPACE	LITERAL1
WM8S_MORSE_CHAR_ELEMENT_MAP_DIFFICULTY_UNUSED	LITERAL1
WM8S_MORSE_CHAR_ELEMENT_MAP_HIELEMENTBIT	LITERAL1
WM8S_MORSE_CHAR_ELEMENT_MAP_OFFSET	LITERAL1
WM8S_MORSE_CHAR_ELEMENT_MAP_UNUSED	LITERAL1
WM8S_MORSE_CITY_MAXLEN	LITERAL1
WM8S_MORSE_DEBUG	LITERAL1
WM8S_MORSE_DEFAULT_ENABLEDDIFFICULTY	LITERAL1
WM8S_MORSE_DEFAULT_OVERALLSPEED	LITERAL1
WM8S_MORSE_DEFAULT_PITCH	LITERAL1
WM8S_MORSE_DEFAULT_RUNMODE	LITERAL1
WM8S_MORSE_DEFAULT_USERCHARSPEED	LITERAL1
WM8S_MORSE_DEFAULT_WPMSCHEMEFACTOR	LITERAL1
WM8S_MORSE_DITS_PER_CHARSPACE	LITERAL1
WM8S_MORSE_DITS_PER_DAH	LITERAL1
WM8S_MORSE_EEPROM_ADDR_HIGHESTENABLEDDIFFICULTY	LITERAL1
WM8S_MORSE_EEPROM_ADDR_OVERALLSPEED	LITERAL1
WM8S_MORSE_EEPROM_ADDR_PITCH	LITERAL1
WM8S_MORSE_EEPROM_ADDR_SIGNATURE	LITERAL1
WM8S_MORSE_EEPROM_ADDR_USERCHARSPEED	LITERAL1
WM8S_MORSE_EEPROM_SIGNATURE_V1	LITERAL1
WM8S_MORSE_EEPROM_WRITE_DELAY	LITERAL1
WM8S_MORSE_FARNSWORTH_CAP	LITERAL1
WM8S_MORSE_FIRSTNAME_MAXLEN	LITERAL1
WM8S_MORSE_MAX_CHARACTER_DIFFICULTY	LITERAL1
WM8S_MORSE_MAX_PITCH	LITERAL1
WM8S_MORSE_MAX_WPM	LITERAL1
WM8S_MORSE_MESSAGE_BUFRSIZE	LITERAL1
WM8S_MORSE_MESSAGE_MAXLEN	LITERAL1
WM8S_MORSE_MIN_CHARACTER_DIFFICULTY	LITERAL1
WM8S_MORSE_MIN_PITCH	LITERAL1
WM8S_MORSE_MIN_WPM	LITERAL1
WM8S_MORSE_NUMBER_MAX	LITERAL1
WM8S_MORSE_NUMBER_MIN	LITERAL1
WM8S_MORSE_PREFIX_MAX	LITERAL1
WM8S_MORSE_PREFIX_MIN	LITERAL1
WM8S_MORSE_QSOPART_MAXLEN	LITERAL1
WM8S_MORSE_RANDOMGROUP_MAX	LITERAL1
WM8S_MORSE_RANDOMGROUP_MIN	LITERAL1
WM8S_MORSE_RST_R_MAX	LITERAL1
WM8S_MORSE_RST_R_MIN	LITERAL1
WM8S_MORSE_RST_S_MAX	LITERAL1
WM8S_MORSE_RST_S_MIN	LITERAL1
WM8S_MORSE_RST_T_MAX	LITERAL1
WM8S_MORSE_RST_T_MIN	LITERAL1
WM8S_MORSE_SUFFIX_MAX	LITERAL1
WM8S_MORSE_SUFFIX_MIN	LITERAL1
WM8S_MORSE_UNUSED_ANALOGPIN	LITERAL1
WM8S_MORSE_WPMSCHEMEFACTOR_CODEX	LITERAL1
WM8S_MORSE_WPMSCHEMEFACTOR_PARIS	LITERAL1